SSSSSSSSSSSSSSSSSSSSSSSSSSSSSSSSSSSSSSSS 
SMMMMMM MMDMBMMMMMMBMBMMMMMMM MMMMBMMMMS 
SMBRBMMHMMM MMMMMMMMMBDMMBMMMM MMMMM MMS 
SMMMMMMHMMT MM MMMMMBMBMMBMMMMMMMMBMMMMS 
SBM  MMHMMMMMMBMMMMMMBMMBMMMMBMMMBMMMMMS 
SBMBBMMMMMMMMMBBMMBMMMMMMMMBMMMMMMBMB MS 
SMMMBMMBMMMMMMMMBMMMMMBM BMMMMMMMMBMBBMS 
SWWWWWWWWWWWWWWWWWWWWWWWWWWWWWWMMMBMMBMS 
SM MMMBMMDM MMBMBMMMMMMMMMMDMB MMMMMMBMS 
SMMDMMMMMBMMMMM MMMMMMMMB  BMMDMMMMBMMMS 
SMMMBMMBMBMMMMMMMMMMMMMMBBMBMMBMMMMMMMMS 
SM MMMMMBMMTMMMMMBB MMMMMMMBMMBMDMMMM MS 
SMBMM MMBMMMMMMMMBMBDMMDMMMMBMMMBMMDMBMS 
SMDBMMMMMMMMMMMMMMBBBMMBMMMMMMMMDMMMMMBS 
SHHHHHHHHWWWWWWWWWWWWWWWWWWWWWWWWWWWWWWS 
S  MMMMMMMMM MMMDMMMMBMMMMMBMMMBMMMMMMMS 
SB MMMMMMMMMBBMMBMMMMMMMMBMMMMMMBMB MMES 
SMBMMBMMMMMMMMBMMMMMBM  MMMMDMMMBMBBMMMS 
SMMMMBDMM MMMMMMMMBMMMMMMBMBDMMMMMMBMMMS 
SMMM MM MBMMBMBBMMMMTMMMMBMBDMMMMMMBMMBS 
SMDMMMMBMMMMM MMMMMMMMM MBMMBMMMMBMMMBMS 
SSSSSSSSSSSSSSSSSSSSSSSSSSSSSSSSSSSSSSSS 