SSSSSSSSSSSSSSSSSSSSSSSSSSSSSSSSSSSSSSSS 
SMBMMBMMWMBMMMDMWMMMTMBMW MMMMMMWMMBBMMS 
SMMMMMMMWMMMMMM WH M MMMW MM MMMWMMMM MS 
S              B BB      B  D        B S 
SDMMMMMMWMBMMMMBWMBM MM WMMBMMDMWMMBHBMS 
SMMMMMMMWMBMMMMBWMBM  MMWMMMMMBMWMMHTHMS 
SWWWWWWWWWWWWWWWWWWB WWWWWWWWWWWWWWHHHWS 
SMMMMBBMWMM MMMMWMMM MMBWMMMM MMWMMMMM S 
SMMMMMMMWMM MMMMWMMB MMMWMMMMBM WMMMMMBS 
S          B                 B        BS 
SBMMBMMMWMMMMBMMWMMBSMMMWMMMMMMDW MMMMMS 
SBMMMMBMWMMBMMBMWMMM M  WMMMMMMMWBMMMBMS 
SMBMMMMMWMMMBMMMWMMM MBBWMMMMMMMWBBMMBMS 
SWWWWWWWWWWWWWWWWWWW WWWWWWWWWWWWWWWWWWS 
SBM F MMWMMMMBMBWMMM MMMWMBDMMBMWMMMMMMS 
SMMMMM MW MMMMMMWMM  MMMW MM MMMWM M  MS 
ST       B         D        B     B BB S 
SDMM MBMWBMMMMBMWMBM MMBWMBMBMMMWMMMMMMS 
SMMMMMBMWBMMDMMMWMMM  MMWMMBMMMMWMMM   S 
SMDMMMB WMM MMMMWMRDBBMMWM MMMMMWMMMBBBS 
SMBMMMMBWMMBMMBMWMSMBMMMWMMMMBMBWMMMMBMS 
SSSSSSSSSSSSSSSSSSSSSSSSSSSSSSSSSSSSSSSS 